11111111111
1P0C00000E1
10111111111
1C0001C0001
111010011C1
1C00100C101
10111111101
1C0000C00C1
11111111111