1111111
1P0C001
1011101
1C0E001
1111111
