111111
1P0C11
101101
11E011
111111
