1111111
1P0C0C1
1011111
1C0E101
1111111