111111111
1P00000E1
101011101
100000001
101111101
100000001
111111111
