    1111111111111111
    100P0000C0000001
    1001000011110001
    1001000000010001
    1001001011110001
    1001111010000001
    1000001011110001
    1C000000000000E1
    1111111111111111