111111111
1P0C000E1
101111111
1C0000C01
101111100
1000000C1
111111111
